{
  "tileset": "furniture",
  "width": 12,
  "height": 10,
  "scale": 64,
  "layers": [
    [
      [-1, -1, -1, -1, -1, -1, -1, -1, -1, -1, -1, -1],
      [-1, -1, -1, -1, -1, -1, -1, -1, -1, -1, -1, -1],
      [-1, 49, 49, 49, 49, 49, 49, 49, 49, 49, 49, -1],
      [-1, 49, 49, 49, 49, 49, 49, 49, 49, 49, 49, -1],
      [-1, 49, 49, 49, 49, 49, 49, 49, 49, 49, 49, -1],
      [-1, 49, 49, 49, 49, 49, 49, 49, 49, 49, 49, -1],
      [-1, -1, -1, -1, 298, 298, 298, 298, -1, -1, -1, -1],
      [-1, -1, -1, -1, 314, 314, 314, 314, -1, -1, -1, -1],
      [-1, -1, -1, -1, 315, 315, 315, 315, -1, -1, -1, -1],
      [-1, -1, -1, -1, -1, -1, -1, -1, -1, -1, -1, -1]
    ],
    [
      [-1, -1, -1, -1, -1, 121, 122, 123, -1, -1, -1, -1],
      [-1, -1, -1, -1, -1, 137, 138, 139, -1, -1, -1, -1],
      [-1, -1, -1, -1, -1, 153, 154, 155, -1, -1, -1, -1],
      [-1, -1, -1, -1, -1, -1, -1, -1, -1, 257, 258, -1],
      [-1, -1, -1, -1, -1, -1, -1, -1, -1, 305, 307, -1],
      [-1, -1, -1, -1, -1, -1, -1, -1, -1, 37, 38, -1],
      [-1, -1, -1, -1, -1, -1, -1, -1, -1, -1, -1, -1],
      [-1, -1, -1, -1, 150, 268, 284, 150, -1, -1, -1, -1],
      [-1, -1, -1, -1, 166, -1, -1, 166, -1, -1, -1, -1],
      [-1, -1, -1, -1, -1, -1, -1, -1, -1, -1, -1, -1]
    ],
    [
      [-1, -1, 264, -1, -1, -1, -1, -1, -1, -1, -1, -1],
      [-1, -1, 280, -1, -1, -1, -1, -1, -1, -1, -1, -1],
      [-1, -1, -1, -1, -1, -1, 148, 149, -1, -1, -1, -1],
      [-1, -1, 11, 13, 12, -1, 164, 165, -1, 240, 241, -1],
      [-1, -1, 27, 29, 28, -1, -1, -1, -1, -1, -1, -1],
      [-1, -1, -1, -1, -1, -1, -1, -1, -1, -1, -1, -1],
      [-1, -1, -1, -1, -1, -1, -1, -1, -1, -1, -1, -1],
      [-1, -1, -1, -1, -1, -1, -1, -1, -1, -1, -1, -1],
      [-1, -1, -1, -1, -1, -1, -1, -1, -1, -1, -1, -1],
      [-1, -1, -1, -1, -1, -1, -1, -1, -1, -1, -1, -1]
    ],
    [
      [-1, -1, -1, -1, -1, -1, -1, -1, -1, -1, -1, -1],
      [-1, -1, -1, -1, -1, -1, -1, -1, -1, -1, -1, -1],
      [-1, -1, -1, -1, -1, -1, -1, -1, -1, -1, -1, -1],
      [-1, -1, 92, 93, 94, -1, -1, -1, -1, -1, -1, -1],
      [-1, -1, 108, 109, 110, -1, -1, -1, -1, -1, -1, -1],
      [-1, -1, -1, -1, -1, -1, -1, -1, -1, -1, -1, -1],
      [-1, -1, -1, -1, -1, -1, -1, -1, -1, -1, -1, -1],
      [-1, -1, -1, -1, -1, -1, -1, -1, -1, -1, -1, -1],
      [-1, -1, -1, -1, -1, -1, -1, -1, -1, -1, -1, -1],
      [-1, -1, -1, -1, -1, -1, -1, -1, -1, -1, -1, -1]
    ]
  ]
}