{
    "tileset": "room_builder",
    "width": 12,
    "height": 10,
    "scale": 64,
    "layers": [
        [
            [-1, 49, 49, 49, 49, 49, 49, 49, 49, 49, 49, -1],
            [-1, 61, 61, 61, 61, 61, 61, 61, 61, 61, 61, -1],
            [-1, -1, -1, -1, -1, -1, -1, -1, -1, -1, -1, -1],
            [-1, -1, -1, -1, -1, -1, -1, -1, -1, -1, -1, -1],
            [-1, -1, -1, -1, -1, -1, -1, -1, -1, -1, -1, -1],
            [-1, -1, -1, -1, -1, -1, -1, -1, -1, -1, -1, -1],
            [-1, -1, -1, -1, -1, -1, -1, -1, -1, -1, -1, -1],
            [-1, -1, -1, -1, -1, -1, -1, -1, -1, -1, -1, -1],
            [-1, -1, -1, -1, -1, -1, -1, -1, -1, -1, -1, -1],
            [-1, -1, -1, -1, -1, -1, -1, -1, -1, -1, -1, -1]
        ],
        [
            [18, 19, 19, 19, 19, 19, 19, 19, 19, 19, 19, 20],
            [30, -1, -1, -1, -1, -1, -1, -1, -1, -1, -1, 32],
            [30, -1, -1, -1, -1, -1, -1, -1, -1, -1, -1, 32],
            [30, -1, -1, -1, -1, -1, -1, -1, -1, -1, -1, 32],
            [30, -1, -1, -1, -1, -1, -1, -1, -1, -1, -1, 32],
            [30, -1, -1, -1, -1, -1, -1, -1, -1, -1, -1, 32],
            [42, 43, 43, 16, -1, -1, -1, -1, 17, 43, 43, 44],
            [-1, -1, -1, 30, -1, -1, -1, -1, 32, -1, -1, -1],
            [-1, -1, -1, 30, -1, -1, -1, -1, 32, -1, -1, -1],
            [-1, -1, -1, 42, 43, -1, -1, 43, 44, -1, -1, -1]
        ]
    ]
}